3333333333333333333333333333333333
3333333333333333333333333333333333
3333333333333333333333333333333333
3330000000000000000000222222200333
3330000000000000000000222222000333
3330000000000000000222222220000333
3330000000000000000222222200000333
3330000000000000000000000000000333
3330000000000000000000000000000333
3330000022222000000000000000000333
3330000022220000000000200000000333
3330000000220000000002200000000333
3330000000022000000000002200000333
3330000000022000000000002200000333
3330000000000000000000000000000333
3330000000000000000002202222200333
3330000000002000000002222222000333
3330000000022000000002222222000333
3330000000022000000000002000000333
3330000000000000000000022200000333
3330000022200000000000022200000333
3330000000000000000000000000000333
3330000000000000000000000000000333
3330000000000000000000000000000333
3330000000000000000000000000000333
3333333333333333333333333333333333
3333333333333333333333333333333333
3333333333333333333333333333333333
0000000000000000000000000000000000